### ### ##  ### # # ###   ### #   # # ##
#   # # # #  #  ### #     #   #   # # # #
#   # # # #  #  ### # #   #   #   # # ##
#   # # # #  #  # # # #   #   #   # # # #
### ### ##  ### # # ###   ### ### ### ##

 #####   #####  #####   ####### #     #  #####
##   ## ##   ## #   ##     #    ##    # ##   ##
#     # #     # #    ##    #    # #   # #     #
#       #     # #     #    #    #  #  # #
#       #     # #     #    #    #   # # #   ###
#     # #     # #    ##    #    #    ## #     #
##   ## ##   ## #   ##     #    #     # ##   ##
 #####   #####  #####   ####### #     #  #####    